Title: Wolf, Goldschakal und Bär in Tirol nachgewiesen - Die Presse	Author: Die Presse	Description: Im Bezirk Innsbruck Land gehen derzeit gleich drei Großraubtiere um.
Title: Realme präsentiert die GT Neo 3 Naruto Edition mit 150 Watt Ladegerät und 50 MP Triple-Kamera - Notebookcheck.com	Author: Hannes Brecher	Description: Kurz vor dem Launch des Realme GT Neo 3 in Europa hat der Hersteller eine neue Naruto Edition des hochwertigen Mittelklasse-Smartphones vorgestellt. Diese bietet nicht nur eine auffällig gestaltete Rückseite, sondern auch eine exklusive Rasengan-Animation bei…
Title: Starbucks eröffnet erste Filiale in Innsbruck - Essen & Trinken - DER STANDARD	Author: null	Description: Ein Pop-up serviert süß und salzig gefüllte Bagels, und Veganista landet am Flughafen Wien
Title: KORREKTUR: PC-Bau leicht gemacht: GIGABYTE stellt AORUS Project Stealth Computer-Bausatz vor - APA OTS	Author: null	Description: GIGABYTE Technology und sein Partner MAINGEAR kündigten heute das neu entwickelte AORUS Project Stealth Computer Assembly Kit und den MAINGEAR Stealth Gaming PC an, die beide eine maßgeschneiderte …
Title: Das Hinspiel im Europacup-Playoff-Finale zwischen der WSG Tirol und Rapid HEUTE LIVE auf Sky Sport Austria - Sky Sport Austria	Author: null	Description: 
Title: Selenskij gegen territoriale Zugeständnisse - KURIER	Author: kurier.at	Description: "Was auch immer der russische Staat tut, es wird sich immer jemand finden, der sagt: Lasst uns seine Interessen berücksichtigen", sagt Selenskij in einer Videoansprache Mittwochabend.
Title: Ein Stich, gegen den es keine Impfung gibt - Die Presse	Author: Veronika Schmidt	Description: Durch den Klimawandel fühlen sich immer mehr tropische Gelsen bei uns wohl. In Wien und Graz gibt es bereits Populationen von Tigermücken, die als Virusüberträger bekannt sind. Die Expertin warnt...
Title: Sony fährt Konsolen-Produktion auf Rekordhöhe hoch - trend.at	Author: null	Description: Elektronikriese will heuer 18 Millionen Playstations verkaufen
Title: Steirische Baugründe um neun Prozent teurer - ORF Steiermark	Author: ORF.at	Description: Lieferengpässe, Teuerungen und die Pandemie haben die Preise auf dem steirischen Immobilienmarkt zuletzt um mehr als neun Prozent ansteigen lassen – das betrifft vor allem Baugrundstücke.
Title: Aktuelles Geschehen - Ukrainische Truppen im Osten unter Druck - Wiener Zeitung	Author: Wiener Zeitung	Description: Alle jüngsten Entwicklungen zum Krieg in der Ukraine gibt es hier im Live-Blog.
Title: TRAUER UND WUT NACH BLUTBAD: Killer kontaktierte wohl 15-jährige Deutsche | WELT Newsstream - WELT Nachrichtensender	Author: null	Description: Bei einer Pressekonferenz zum Schusswaffenmassaker an einer Grundschule im texanischen Uvalde hat der bekannte US-Demokrat Beto O'Rourke für einen Eklat geso...
Title: Bühne Baden zeigt „Charisma und Historie“ - ORF NÖ	Author: ORF.at	Description: Legendäre Persönlichkeiten stehen im Zentrum der Saison 2022/23 in der Bühne Baden. Unter dem Motto „Charisma und Historie“ wird ein Mix aus Oper, Operette und Musical geboten.
Title: Bitcoin & Co: Brutaler Crash - finanzen.net	Author: finanzen.net Redaktion	Description: Die Kurse am Kryptomarkt haben ihre Talfahrt dramatisch beschleunigt. Einen Coin trifft es dabei ganz besonders hart.
Title: Winzerin und Popstar machen Wein - ORF	Author: ORF.at	Description: Die junge Winzerin Carina Pluschkovits aus Leithaprodersdorf verbindet mit dem belgischen Popstar Milow eine Freundschaft. Ein Rose Brut ist nun das erste gemeinsame Projekt der beiden. Dessen Etikett ist identisch  mit dem Cover von Milows neuem Album „Nice …
Title: Tech-Konzern - Inflation: Apple erhöht Löhne für US-Mitarbeiter -  cash	Author: Reuters	Description: Apple will einem Zeitungsbericht zufolge angesichts der zunehmenden Inflation den Stundenlohn für seine Mitarbeiter in den USA erhöhen.
Title: Favorit bis Enyaq: 30 Jahre Erfolgsgeschichte von Skoda in Österreich - motor.at	Author: Horst Bauer	Description: Die Meilensteine von Skoda in den vergangenen drei Jahrzehnten - und warum jetzt oft viel Geduld gefragt ist
Title: "Apico" - Wir retten die Welt der Bienen - FM4	Author: null	Description: Pünktlich zum Weltbienentag am 20. Mai gibt es jetzt das Spiel „Apico“, in dem man in die Rolle eines Imkers schlüpfen kann. Ein Wholesome Indie Game ohne Stress.
Title: Conference League: Roma feiert Premierentriumph - ORF	Author: ORF.at	Description: Der allererste Sieger der UEFA Europa Conference League heißt AS Roma. Die italienische Mannschaft von Starcoach Jose Mourinho gewann am Mittwoch das Premierenfinale in diesem Bewerb vor 21.690 Zuschauern in Tirana gegen Feyenoord Rotterdam mit 1:0 (1:0). Für…
Title: Ukraine vermeldet „sehr schwierigen Moment an der Front“ - ORF.at	Author: ORF.at	Description: 
Title: „Fließt kein Gas, gibt es keine Lebensmittel“ - KURIER	Author: kurier.at	Description: Kritische Stimmen in der ZiB2 zu einem möglichen sofortigen Gas-Lieferstopp in der Ukraine-Krise.
Title: Ukrainische Verteidiger im Osten enorm unter Druck - DER STANDARD	Author: null	Description: Die USA lassen eine Ausnahmeregel zur Schuldenbegleichung auslaufen, damit droht Russland nun der Zahlungsausfall. Auslandschulden sollen nunmehr in Rubel beglichen werden
Title: Händel, Viola und Haydn in Barcelona | MI | 25 05 2022 | 19:30 - ORF.at	Author: null	Description: präsentiert von Colin Mason. Escolania de Montserrat; Capella de Música de Montserrat; Orquestra Simfònica del Vallès, Leitung: Xavier Pulg; Xavier Mendoza, Bariton; Roger Padullés, Tenor. Georg Fr...
Title: 2. Klasse West 2021/2022: Tipp-Spiel Runde 24 - ligaportal.at	Author: Ligaportal	Description: Fußball in Oberösterreich. Hier finden Sie alle Fußball Ergebnisse, Tabellen und Torschützen aus Oberösterreich. Jetzt kostenlos die Fußball App für Ihr Handy holen!
Title: Unwettereinsätze & Universitätsprofessor mit 27: Das war der Mittwoch in der Steiermark - Steiermark - meinbezirk.at	Author: Lisa Jeuschnigger	Description: Überschwemmungen in Tiefgaragen und überflutete Straßen: Die steirischen Feuerwehren mussten in der Nacht auf Mittwoch wieder einmal zu Unwettereinsätzen ausrücken. Und: Der eine liebt die Bücher, die andere den Gatsch.
Title: Syphilis, Tripper und Co. - Das Comeback der Geschlechtskrankheiten - FM4	Author: null	Description: Sexuell übertragbare Erkrankungen nehmen seit einigen Jahren wieder zu. Die WHO spricht von einer „stillen Epidemie“. Welche sind in Österreich gerade besonders häufig? Welche bleiben lange unbemerkt? Wie werden sie behandelt? Und wie kann ich mich schützen?
Title: Gesundheitsminister Rauch bei „Milborn“: „Foul von Peter Hacker“ - APA OTS	Author: null	Description: Konflikt um Corona-Maßnahmen: Der grüne Gesundheitsminister ortet „ein Stück weit Parteipolitik“ beim Wiener SPÖ-Stadtrat
Title: Erneuerbare Energie - Öl und Gas: Lustenau präsentiert Ausstiegsplan | krone.at - Kronen Zeitung	Author: Vorarlberg-Krone	Description: Biomasse-Heizwerk mit Fernwärmenetz soll ab Herbst 2024 Wärme an Schulen, Unternehmen und Privathaushalte liefern. ...
Title: Partnerschaft der Landtage: Gemeinsame Interessen sind Kitt der Regionen - KURIER	Author: Michaela Höberth	Description: Seit 30 Jahren sind die Landtage von Niederösterreich und dem deutschen Sachsen Partner.
Title: Corona lässt Anzahl der Herzerkrankungen steigen - Heute.at	Author: heute.at	Description: Die verschiedenen medizinischen Bereiche müssen sich konstant an die aktuelle Lage anpassen und nichtsahnende Corona-Patienten aufklären.
Title: Keine Verlängerung: Rapid und Stojkovic gehen getrennte Wege - KURIER	Author: kurier.at	Description: Der Montenegriner ließ die Frist für das neue Angebot der Hütteldorfer verstreichen.
Title: ÖBB überlegen auch Reservierungspflicht - VOL.AT 	Author: vpircher	Description: Nachdem die Auslastung der ÖBB-Züge vor allem im Fernverkehr wieder anzieht und die Staatsbahn speziell vor starken Reiseterminen Sitzplatzreservierungen dringend empfiehlt, gibt es nun offenbar auch kein Denkverbot in Richtung Reservierungspflicht mehr.
Title: Viagra kann Augen beeinflussen - BLO24.at	Author: BLO24	Description: Viagra kann Farbenblindheit und erhöhte Lichtempfindlichkeit auslösen
Title: HIV/AIDS - Sozialministerium	Author: null	Description: 
